15
15
#.###########################.#
#...........#.....#.....#.....#
#########.###.###.#.#.#####.###
#.........#...#.#.#.#.....#...#
#.#########.###.###.#####.###.#
#.........#.#.#.....#.....#...#
#.#######.#.#.#######.###.#.###
#...#...#.#.#.....#...#...#...#
###.###.#.#.#####.#.#########.#
#.#.#...#.#.......#.....#...#.#
#.#.#.###.#####.###.###.#.#.#.#
#.....#...#.........#...#.#...#
###.###.#.#.........#.###.###.#
#.#.#...#...........#.#...#...#
#.#####.###.........#.#.#####.#
#...#.....#.........#.......#.#
#.#.#######.........###.###.#.#
#.#.#.....#...........#.#...#.#
#.#.#####.#.........#.###.###.#
#.#.....#...........#...#.#...#
#.###.#.#.#########.#.###.#.###
#...#.#.#...#.....#.#...#.#...#
###.#.#####.#.###.#.#.#.#####.#
#...#.......#.#.#...#.#.#.#...#
#.###.#######.#.###.#.#.#.#.###
#.#.#.#.....#.....#.#.#.#.#.#.#
#.#.#####.###########.###.#.#.#
#...#...#.#...........#.....#.#
#.#.#.#.#.#.###.#######.#####.#
#.#...#.#.....#...#...........#
#.###########################.#